01211111111111111122
00200000010000500022
55455555510000500022
55455555555010300022
01210000055000500122
01200110035555555542
01200110035553355542
01200110055000001022
55455555555000000022
55455555335000100022
00200151155000011122
10200151155355555522
10200055555000000022
10211000055011111122
22222222244222222222
22222222244222222222
22444444444444444442
22444444444444444442
22222222244222222222
22222222222222222222